Stage 1
#####
#OoP#
#####
=====
Stage 2
  #######
###  O  ###
#    o    #
# Oo P oO #
###  o  ###
 #   O  # 
 ########
=====
Stage 3
  ###
  #O#
  # ####
###o oO#
#O oP###
####o#
   #O#
   ###
=====
Stage 4
####
# O#
#  #
#  ###
#O P #
#o o #
#  ###
####
=====
Stage 5
#####
#P  #
#   # ###
# oo# #O#
# o ###O#
###    O#
 ##     #
 #   #  #
 #   ####
 #####